{
  "type": "RAW",
  "version": 1,
  "ordinal": 4,
  "name": "Maze 8x8",
  "regions": [
    {
      "base": {
        "points": [
          {"x": 0, "y": 0},
          {"x": 800, "y": 0},
          {"x": 800, "y": 200},
          {"x": 700, "y": 200},
          {"x": 700, "y": 100},
          {"x": 100, "y": 100},
          {"x": 100, "y": 200},
          {"x": 0, "y": 200}
        ]
      },
      "holes": []
    },
    {
      "base": {
        "points": [
          {"x": 100, "y": 100},
          {"x": 500, "y": 100},
          {"x": 500, "y": 200},
          {"x": 200, "y": 200},
          {"x": 200, "y": 300},
          {"x": 100, "y": 300},
          {"x": 100, "y": 400},
          {"x": 200, "y": 400},
          {"x": 200, "y": 500},
          {"x": 0, "y": 500},
          {"x": 0, "y": 200},
          {"x": 100, "y": 200}
        ]
      },
      "holes": []
    },
    {
      "base": {
        "points": [
          {"x": 500, "y": 100},
          {"x": 700, "y": 100},
          {"x": 700, "y": 200},
          {"x": 800, "y": 200},
          {"x": 800, "y": 800},
          {"x": 700, "y": 800},
          {"x": 700, "y": 300},
          {"x": 600, "y": 300},
          {"x": 600, "y": 200},
          {"x": 500, "y": 200}
        ]
      },
      "holes": []
    },
    {
      "base": {
        "points": [
          {"x": 200, "y": 200},
          {"x": 400, "y": 200},
          {"x": 400, "y": 300},
          {"x": 300, "y": 300},
          {"x": 300, "y": 500},
          {"x": 400, "y": 500},
          {"x": 400, "y": 600},
          {"x": 300, "y": 600},
          {"x": 300, "y": 700},
          {"x": 100, "y": 700},
          {"x": 100, "y": 600},
          {"x": 200, "y": 600},
          {"x": 200, "y": 400},
          {"x": 100, "y": 400},
          {"x": 100, "y": 300},
          {"x": 200, "y": 300}
        ]
      },
      "holes": []
    },
    {
      "base": {
        "points": [
          {"x": 400, "y": 200},
          {"x": 600, "y": 200},
          {"x": 600, "y": 300},
          {"x": 500, "y": 300},
          {"x": 500, "y": 400},
          {"x": 300, "y": 400},
          {"x": 300, "y": 300},
          {"x": 400, "y": 300}
        ]
      },
      "holes": []
    },
    {
      "base": {
        "points": [
          {"x": 500, "y": 300},
          {"x": 700, "y": 300},
          {"x": 700, "y": 800},
          {"x": 600, "y": 800},
          {"x": 600, "y": 400},
          {"x": 500, "y": 400}
        ]
      },
      "holes": []
    },
    {
      "base": {
        "points": [
          {"x": 300, "y": 400},
          {"x": 600, "y": 400},
          {"x": 600, "y": 500},
          {"x": 500, "y": 500},
          {"x": 500, "y": 700},
          {"x": 400, "y": 700},
          {"x": 400, "y": 800},
          {"x": 200, "y": 800},
          {"x": 200, "y": 700},
          {"x": 300, "y": 700},
          {"x": 300, "y": 600},
          {"x": 400, "y": 600},
          {"x": 400, "y": 500},
          {"x": 300, "y": 500}
        ]
      },
      "holes": []
    },
    {
      "base": {
        "points": [
          {"x": 0, "y": 500},
          {"x": 200, "y": 500},
          {"x": 200, "y": 600},
          {"x": 100, "y": 600},
          {"x": 100, "y": 700},
          {"x": 200, "y": 700},
          {"x": 200, "y": 800},
          {"x": 0, "y": 800}
        ]
      },
      "holes": []
    },
    {
      "base": {
        "points": [
          {"x": 500, "y": 500},
          {"x": 600, "y": 500},
          {"x": 600, "y": 800},
          {"x": 400, "y": 800},
          {"x": 400, "y": 700},
          {"x": 500, "y": 700}
        ]
      },
      "holes": []
    }
  ],
  "neighboursList": [
    [1, 2],
    [0, 2, 3, 4, 7],
    [0, 1, 4, 5],
    [1, 4, 6, 7],
    [1, 2, 3, 5, 6],
    [2, 4, 6, 8],
    [3, 4, 5, 7, 8],
    [1, 3, 6],
    [5, 6]
  ]
}